Rolls,English,Math,Science,Social Science,Total Marks,Grades
100,58,47,57,86,248,B
101,65,42,20,53,180,C
102,60,42,52,47,201,C
103,41,89,87,62,279,B
104,57,43,73,58,231,C
105,62,41,49,56,208,C
106,79,63,41,40,223,C
107,73,60,49,56,238,C
108,40,29,82,40,191,C
109,77,70,40,49,236,C
110,48,57,64,84,253,B
111,50,72,69,73,264,B
112,81,79,30,44,234,C
113,49,68,31,78,226,C
114,35,52,55,51,193,C
115,23,47,23,34,127,D
116,42,77,80,66,265,B
117,46,90,82,66,284,B
118,69,67,52,89,277,B
119,74,51,58,64,247,B
120,53,46,60,78,237,C
121,37,71,23,47,178,C
122,66,53,56,21,196,C
123,22,40,84,45,191,C
124,58,40,82,58,238,C
125,49,79,47,61,236,C
126,81,89,89,81,340,A
127,42,26,61,59,188,C
128,39,42,74,30,185,C
129,63,67,90,43,263,B
130,40,79,70,25,214,C
131,78,23,36,38,175,C
132,90,32,32,74,228,C
133,73,60,41,72,246,B
134,47,80,69,71,267,B
135,20,58,25,60,163,C
136,29,62,77,90,258,B
137,69,68,61,65,263,B
138,48,36,80,62,226,C
139,89,70,87,48,294,B
140,46,74,53,61,234,C
141,60,20,37,62,179,C
142,39,65,89,57,250,B
143,48,43,56,53,200,C
144,46,35,55,37,173,C
145,45,86,70,35,236,C
146,71,33,46,82,232,C
147,37,41,39,40,157,D
148,62,48,45,52,207,C
149,69,26,81,90,266,B
150,39,53,82,62,236,C
151,61,29,81,21,192,C
152,35,81,20,81,217,C
153,68,66,64,86,284,B
154,59,41,23,30,153,D
155,68,57,86,37,248,B
156,82,39,34,48,203,C
157,75,82,31,47,235,C
158,57,70,40,40,207,C
159,87,35,63,55,240,B
160,65,28,54,26,173,C
161,70,21,35,62,188,C
162,50,57,48,58,213,C
163,48,40,70,67,225,C
164,81,67,38,62,248,B
165,22,70,87,63,242,B
166,22,22,83,32,159,D
167,68,58,23,36,185,C
168,68,90,23,37,218,C
169,44,70,57,47,218,C
170,64,30,48,22,164,C
171,35,51,84,28,198,C
172,79,34,50,76,239,C
173,25,68,26,48,167,C
174,58,81,66,79,284,B
175,30,77,23,63,193,C
176,38,83,32,60,213,C
177,25,50,49,38,162,C
178,31,84,23,41,179,C
179,64,72,24,32,192,C
180,79,88,59,40,266,B
181,56,37,73,21,187,C
182,24,40,66,66,196,C
183,33,52,84,43,212,C
184,43,27,78,64,212,C
185,53,59,64,87,263,B
186,80,78,27,72,257,B
187,28,62,37,55,182,C
188,22,38,52,81,193,C
189,67,29,58,57,211,C
190,58,71,34,61,224,C
191,67,52,58,50,227,C
192,35,52,82,39,208,C
193,25,62,56,75,218,C
194,23,66,65,35,189,C
195,41,54,66,25,186,C
196,81,48,87,20,236,C
197,39,48,22,20,129,D
198,31,42,40,51,164,C
199,34,68,60,32,194,C
200,30,56,41,66,193,C
201,79,79,46,47,251,B
202,26,84,79,64,253,B
203,90,69,27,75,261,B
204,75,36,83,65,259,B
205,37,87,61,65,250,B
206,90,32,38,65,225,C
207,72,26,27,73,198,C
208,47,75,68,24,214,C
209,88,69,26,52,235,C
210,62,75,38,29,204,C
211,38,25,44,63,170,C
212,25,40,49,68,182,C
213,38,71,65,29,203,C
214,85,45,59,28,217,C
215,64,35,33,60,192,C
216,27,65,89,71,252,B
217,87,32,45,90,254,B
218,35,71,22,77,205,C
219,23,40,42,81,186,C
220,78,42,87,62,269,B
221,65,24,58,50,197,C
222,71,46,70,69,256,B
223,87,89,88,24,288,B
224,63,31,63,49,206,C
225,84,73,30,41,228,C
226,52,67,21,65,205,C
227,89,63,60,43,255,B
228,44,42,31,79,196,C
229,59,82,45,34,220,C
230,32,85,24,32,173,C
231,50,50,49,69,218,C
232,42,49,43,84,218,C
233,43,75,36,65,219,C
234,78,49,53,44,224,C
235,89,35,58,47,229,C
236,72,66,82,87,307,B
237,58,54,26,23,161,C
238,28,21,69,73,191,C
239,29,79,69,84,261,B
240,28,49,43,39,159,D
241,80,84,47,43,254,B
242,25,78,84,88,275,B
243,41,45,22,43,151,D
244,34,36,59,67,196,C
245,32,28,65,23,148,D
246,65,20,78,33,196,C
247,56,87,86,24,253,B
248,68,39,65,45,217,C
249,75,41,23,23,162,C
250,22,34,53,60,169,C
251,64,60,23,84,231,C
252,27,57,42,42,168,C
253,81,48,49,55,233,C
254,61,72,48,28,209,C
255,49,53,57,66,225,C
256,61,46,33,42,182,C
257,61,89,83,51,284,B
258,89,66,30,79,264,B
259,28,29,30,75,162,C
260,84,48,33,32,197,C
261,51,69,30,52,202,C
262,64,59,73,71,267,B
263,65,78,21,69,233,C
264,76,85,87,57,305,B
265,63,74,72,26,235,C
266,33,52,54,55,194,C
267,76,83,68,28,255,B
268,56,83,67,60,266,B
269,60,40,36,24,160,C
270,64,59,33,28,184,C
271,52,73,86,81,292,B
272,46,28,38,26,138,D
273,54,48,38,82,222,C
274,78,58,36,89,261,B
275,67,32,73,87,259,B
276,65,73,40,72,250,B
277,55,86,56,33,230,C
278,79,76,47,62,264,B
279,31,66,46,73,216,C
280,32,62,71,46,211,C
281,23,41,84,71,219,C
282,72,44,36,31,183,C
283,49,39,51,32,171,C
284,66,87,40,24,217,C
285,75,37,37,52,201,C
286,57,43,88,49,237,C
287,38,38,60,36,172,C
288,50,78,47,64,239,C
289,72,45,84,46,247,B
290,47,23,63,51,184,C
291,20,42,21,87,170,C
292,56,43,88,42,229,C
293,90,79,51,53,273,B
294,26,66,26,73,191,C
295,22,37,74,52,185,C
296,38,73,26,70,207,C
297,86,34,90,43,253,B
298,30,38,35,20,123,D
299,76,84,34,23,217,C
300,74,72,53,21,220,C
301,72,20,70,55,217,C
302,48,82,78,56,264,B
303,56,62,45,45,208,C
304,52,90,58,23,223,C
305,54,55,49,47,205,C
306,32,59,26,22,139,D
307,70,30,45,53,198,C
308,68,44,40,26,178,C
309,25,90,45,60,220,C
310,40,27,49,20,136,D
311,76,21,49,79,225,C
312,28,48,82,59,217,C
313,76,66,72,57,271,B
314,74,45,22,81,222,C
315,45,78,65,45,233,C
316,58,38,36,50,182,C
317,40,30,21,66,157,D
318,68,65,28,46,207,C
319,37,69,26,25,157,D
320,44,35,68,31,178,C
321,43,50,26,49,168,C
322,41,20,53,84,198,C
323,86,74,38,47,245,B
324,80,89,39,49,257,B
325,49,61,80,21,211,C
326,45,38,44,82,209,C
327,76,43,78,28,225,C
328,79,82,87,68,316,B
329,28,55,74,34,191,C
330,33,67,66,46,212,C
331,24,21,31,57,133,D
332,45,79,32,72,228,C
333,24,65,44,43,176,C
334,75,85,38,40,238,C
335,47,67,74,49,237,C
336,57,38,57,36,188,C
337,27,48,57,45,177,C
338,80,85,76,25,266,B
339,32,52,72,85,241,B
340,70,61,35,45,211,C
341,39,52,37,45,173,C
342,81,85,61,35,262,B
343,58,90,81,35,264,B
344,37,42,84,76,239,C
345,51,75,83,54,263,B
346,35,24,61,71,191,C
347,62,69,53,48,232,C
348,62,78,20,71,231,C
349,42,24,46,70,182,C
350,41,31,42,24,138,D
351,59,47,21,84,211,C
352,25,78,48,90,241,B
353,45,36,70,90,241,B
354,35,57,64,30,186,C
355,36,23,33,62,154,D
356,70,39,45,46,200,C
357,34,73,62,23,192,C
358,42,64,78,49,233,C
359,63,29,71,88,251,B
360,55,29,81,54,219,C
361,82,26,74,75,257,B
362,33,41,54,28,156,D
363,22,58,72,64,216,C
364,65,31,24,40,160,C
365,25,58,31,53,167,C
366,51,55,77,34,217,C
367,44,54,86,87,271,B
368,25,54,62,32,173,C
369,72,27,63,22,184,C
370,43,67,71,80,261,B
371,30,26,78,58,192,C
372,68,80,42,28,218,C
373,70,44,77,54,245,B
374,33,22,56,72,183,C
375,34,32,20,83,169,C
376,70,61,65,60,256,B
377,88,53,59,90,290,B
378,43,53,81,63,240,B
379,22,33,84,70,209,C
380,53,23,83,37,196,C
381,34,44,47,83,208,C
382,33,64,36,23,156,D
383,74,60,57,76,267,B
384,24,46,85,90,245,B
385,32,88,50,59,229,C
386,23,88,39,80,230,C
387,79,64,73,78,294,B
388,57,72,61,44,234,C
389,74,38,58,32,202,C
390,45,29,23,23,120,D
391,52,65,21,37,175,C
392,58,38,47,78,221,C
393,48,53,87,65,253,B
394,74,65,39,79,257,B
395,58,57,20,37,172,C
396,30,34,79,48,191,C
397,79,69,36,46,230,C
398,79,82,56,69,286,B
399,83,35,33,83,234,C
400,45,41,55,32,173,C
401,54,26,56,78,214,C
402,70,34,39,90,233,C
403,68,58,70,37,233,C
404,57,76,22,46,201,C
405,30,67,55,53,205,C
406,89,26,29,32,176,C
407,58,56,78,68,260,B
408,48,36,70,53,207,C
409,58,31,57,48,194,C
410,28,29,50,62,169,C
411,50,33,35,86,204,C
412,36,66,63,85,250,B
413,38,54,22,66,180,C
414,63,61,84,63,271,B
415,66,76,29,82,253,B
416,76,28,24,83,211,C
417,56,71,29,69,225,C
418,39,26,70,38,173,C
419,40,55,21,30,146,D
420,73,54,83,83,293,B
421,70,72,76,57,275,B
422,83,56,69,39,247,B
423,44,57,80,72,253,B
424,53,82,65,28,228,C
425,33,59,26,32,150,D
426,84,43,26,81,234,C
427,67,20,25,69,181,C
428,61,32,48,82,223,C
429,28,76,75,38,217,C
430,86,57,37,66,246,B
431,34,85,33,44,196,C
432,38,70,53,21,182,C
433,83,51,86,56,276,B
434,41,76,37,25,179,C
435,51,62,65,37,215,C
436,27,66,47,29,169,C
437,58,26,42,42,168,C
438,83,51,75,72,281,B
439,73,68,33,24,198,C
440,48,48,31,35,162,C
441,81,64,36,31,212,C
442,40,63,22,81,206,C
443,33,44,61,52,190,C
444,75,74,47,31,227,C
445,69,56,28,60,213,C
446,36,89,63,33,221,C
447,24,86,64,58,232,C
448,77,40,41,75,233,C
449,35,78,26,65,204,C
450,55,41,20,43,159,D
451,23,27,34,84,168,C
452,59,44,80,88,271,B
453,63,78,27,27,195,C
454,39,49,39,58,185,C
455,55,48,66,89,258,B
456,55,63,53,42,213,C
457,45,74,45,33,197,C
458,43,80,30,57,210,C
459,70,77,70,26,243,B
460,21,30,29,43,123,D
461,70,64,20,77,231,C
462,74,77,55,28,234,C
463,30,63,89,77,259,B
464,35,61,48,28,172,C
465,85,60,43,39,227,C
466,80,78,88,37,283,B
467,41,41,74,60,216,C
468,68,37,51,33,189,C
469,41,51,21,20,133,D
470,70,40,22,73,205,C
471,76,86,23,36,221,C
472,32,84,27,21,164,C
473,59,64,78,57,258,B
474,41,34,78,30,183,C
475,58,33,22,52,165,C
476,31,31,37,55,154,D
477,27,39,71,82,219,C
478,88,82,69,55,294,B
479,88,24,20,73,205,C
480,21,64,75,87,247,B
481,48,79,47,56,230,C
482,44,55,47,34,180,C
483,73,25,22,84,204,C
484,54,63,43,85,245,B
485,67,78,43,90,278,B
486,55,68,27,90,240,B
487,85,44,69,62,260,B
488,35,48,35,72,190,C
489,33,57,25,54,169,C
490,79,73,90,32,274,B
491,80,80,84,44,288,B
492,45,77,90,32,244,B
493,89,81,26,68,264,B
494,57,57,30,61,205,C
495,36,74,49,62,221,C
496,69,70,58,27,224,C
497,23,84,68,25,200,C
498,60,36,82,55,233,C
499,87,50,41,87,265,B
500,76,89,48,76,289,B
501,62,45,45,20,172,C
502,55,61,64,80,260,B
503,86,27,22,74,209,C
504,45,59,89,62,255,B
505,66,47,20,32,165,C
506,39,60,37,65,201,C
507,23,69,40,74,206,C
508,54,80,64,40,238,C
509,30,71,72,26,199,C
510,21,70,86,62,239,C
511,78,45,47,56,226,C
512,60,33,69,42,204,C
513,89,87,72,65,313,B
514,87,35,25,89,236,C
515,85,90,77,39,291,B
516,80,64,71,76,291,B
517,47,90,42,31,210,C
518,33,62,32,32,159,D
519,36,50,61,40,187,C
520,59,83,38,45,225,C
521,49,85,74,32,240,B
522,25,47,62,76,210,C
523,84,61,86,44,275,B
524,39,68,44,77,228,C
525,47,77,41,35,200,C
526,58,57,88,35,238,C
527,26,46,42,26,140,D
528,44,38,72,74,228,C
529,80,29,64,76,249,B
530,63,20,48,50,181,C
531,54,38,25,60,177,C
532,78,41,88,31,238,C
533,61,84,27,86,258,B
534,70,69,60,21,220,C
535,41,83,52,68,244,B
536,75,81,66,87,309,B
537,66,47,40,66,219,C
538,66,88,62,49,265,B
539,37,30,74,56,197,C
540,41,48,82,90,261,B
541,22,65,27,79,193,C
542,37,78,81,53,249,B
543,83,23,37,39,182,C
544,75,66,55,54,250,B
545,77,58,37,55,227,C
546,51,61,82,27,221,C
547,40,20,72,84,216,C
548,82,45,43,43,213,C
549,81,71,75,56,283,B
550,81,75,48,44,248,B
551,53,49,30,23,155,D
552,39,25,81,81,226,C
553,43,84,56,23,206,C
554,32,73,82,74,261,B
555,45,52,65,85,247,B
556,32,37,66,57,192,C
557,70,78,37,52,237,C
558,83,60,72,74,289,B
559,48,71,86,34,239,C
560,59,88,75,65,287,B
561,78,80,81,20,259,B
562,43,25,80,20,168,C
563,90,23,53,38,204,C
564,81,50,54,20,205,C
565,84,64,88,48,284,B
566,88,58,26,84,256,B
567,21,29,26,61,137,D
568,54,47,64,21,186,C
569,65,54,42,34,195,C
570,82,35,60,67,244,B
571,67,47,69,87,270,B
572,35,87,34,28,184,C
573,20,23,35,35,113,D
574,23,30,47,25,125,D
575,88,49,40,54,231,C
576,38,49,55,44,186,C
577,73,63,84,22,242,B
578,88,82,46,61,277,B
579,39,88,28,59,214,C
580,26,65,23,52,166,C
581,36,46,22,86,190,C
582,59,63,77,64,263,B
583,81,76,74,71,302,B
584,88,81,40,90,299,B
585,23,36,87,32,178,C
586,45,34,54,62,195,C
587,42,49,73,73,237,C
588,24,44,40,64,172,C
589,43,80,83,66,272,B
590,46,71,28,44,189,C
591,75,40,60,85,260,B
592,88,58,44,51,241,B
593,53,40,65,65,223,C
594,65,42,33,88,228,C
595,81,21,30,45,177,C
596,34,84,49,50,217,C
597,49,53,71,38,211,C
598,74,36,48,65,223,C
599,75,86,47,66,274,B
600,82,52,21,58,213,C
601,22,64,40,21,147,D
602,84,66,85,78,313,B
603,88,55,46,48,237,C
604,78,40,25,77,220,C
605,58,69,61,29,217,C
606,90,49,29,69,237,C
607,35,73,40,45,193,C
608,44,50,88,87,269,B
609,37,34,86,20,177,C
610,22,23,47,24,116,D
611,69,63,50,79,261,B
612,22,55,27,53,157,D
613,36,87,21,81,225,C
614,28,46,61,54,189,C
615,52,71,57,22,202,C
616,50,62,28,40,180,C
617,85,59,32,67,243,B
618,37,40,39,66,182,C
619,43,28,65,74,210,C
620,56,21,74,46,197,C
621,38,52,59,39,188,C
622,31,64,60,49,204,C
623,26,88,31,23,168,C
624,35,33,79,86,233,C
625,51,60,21,85,217,C
626,67,36,71,34,208,C
627,36,81,62,45,224,C
628,51,58,76,63,248,B
629,51,70,85,52,258,B
630,36,90,24,41,191,C
631,44,80,73,69,266,B
632,84,61,85,80,310,B
633,70,65,38,39,212,C
634,48,20,46,77,191,C
635,72,32,41,89,234,C
636,47,62,64,63,236,C
637,80,42,50,29,201,C
638,63,43,57,43,206,C
639,78,38,23,25,164,C
640,35,69,39,24,167,C
641,89,62,52,44,247,B
642,65,49,49,77,240,B
643,34,80,30,64,208,C
644,39,85,35,34,193,C
645,84,75,25,70,254,B
646,33,37,22,28,120,D
647,89,23,47,26,185,C
648,44,50,82,44,220,C
649,85,82,78,21,266,B
650,28,33,68,60,189,C
651,25,33,68,23,149,D
652,56,22,55,50,183,C
653,57,45,87,60,249,B
654,88,76,63,86,313,B
655,85,71,38,70,264,B
656,35,31,34,68,168,C
657,43,53,54,85,235,C
658,36,56,70,90,252,B
659,84,82,53,73,292,B
660,21,76,70,49,216,C
661,51,81,67,61,260,B
662,40,59,28,75,202,C
663,65,82,51,24,222,C
664,51,61,32,32,176,C
665,55,84,55,57,251,B
666,51,47,28,59,185,C
667,54,77,44,64,239,C
668,69,60,48,40,217,C
669,63,46,26,90,225,C
670,40,31,46,42,159,D
671,85,67,45,21,218,C
672,82,43,59,36,220,C
673,50,21,20,47,138,D
674,66,29,26,73,194,C
675,52,82,32,44,210,C
676,29,80,59,64,232,C
677,47,60,49,65,221,C
678,76,45,39,77,237,C
679,69,39,75,59,242,B
680,36,74,63,42,215,C
681,47,71,75,83,276,B
682,69,54,67,85,275,B
683,40,66,45,47,198,C
684,87,69,22,62,240,B
685,50,62,42,55,209,C
686,58,51,78,47,234,C
687,63,35,29,48,175,C
688,40,79,25,21,165,C
689,54,80,90,39,263,B
690,61,78,56,80,275,B
691,43,85,48,25,201,C
692,68,35,85,60,248,B
693,40,45,64,73,222,C
694,34,61,72,44,211,C
695,36,21,53,71,181,C
696,86,69,81,36,272,B
697,82,73,79,81,315,B
698,51,37,41,77,206,C
699,53,85,86,87,311,B
700,90,53,79,71,293,B
701,88,35,47,48,218,C
702,78,43,78,39,238,C
703,71,73,29,59,232,C
704,60,20,43,24,147,D
705,25,85,66,60,236,C
706,89,73,33,27,222,C
707,36,71,67,63,237,C
708,21,66,52,21,160,C
709,25,58,85,31,199,C
710,47,79,44,22,192,C
711,66,42,23,75,206,C
712,21,22,84,65,192,C
713,29,40,49,86,204,C
714,76,73,41,83,273,B
715,23,43,59,56,181,C
716,84,54,73,38,249,B
717,77,27,68,32,204,C
718,60,65,57,54,236,C
719,20,59,56,27,162,C
720,53,33,42,52,180,C
721,61,68,20,68,217,C
722,36,64,39,31,170,C
723,51,60,29,60,200,C
724,25,84,80,20,209,C
725,67,62,75,65,269,B
726,81,25,89,59,254,B
727,46,48,49,58,201,C
728,32,43,28,32,135,D
729,83,84,58,44,269,B
730,81,38,44,43,206,C
731,55,77,51,85,268,B
732,68,62,55,85,270,B
733,47,64,26,89,226,C
734,79,35,25,46,185,C
735,76,27,88,90,281,B
736,66,58,54,81,259,B
737,52,63,52,23,190,C
738,71,31,39,20,161,C
739,71,27,39,47,184,C
740,85,35,31,88,239,C
741,76,77,67,61,281,B
742,71,59,82,46,258,B
743,20,36,60,63,179,C
744,86,59,88,56,289,B
745,78,87,87,49,301,B
746,32,25,57,29,143,D
747,37,32,25,51,145,D
748,43,22,50,83,198,C
749,69,85,72,28,254,B
750,41,22,45,57,165,C
751,31,36,78,27,172,C
752,27,25,44,75,171,C
753,23,22,90,45,180,C
754,80,81,89,61,311,B
755,47,29,45,57,178,C
756,66,33,75,45,219,C
757,74,52,58,80,264,B
758,24,66,44,31,165,C
759,79,40,61,30,210,C
760,52,88,89,55,284,B
761,78,38,68,62,246,B
762,63,63,46,52,224,C
763,35,82,33,85,235,C
764,49,38,72,66,225,C
765,63,42,61,44,210,C
766,52,31,74,63,220,C
767,49,34,28,83,194,C
768,73,64,27,76,240,B
769,33,76,55,44,208,C
770,61,66,70,68,265,B
771,85,30,69,45,229,C
772,45,88,88,23,244,B
773,86,81,39,53,259,B
774,20,48,26,48,142,D
775,80,26,73,37,216,C
776,62,83,20,37,202,C
777,55,43,77,24,199,C
778,35,41,74,27,177,C
779,45,28,60,83,216,C
780,20,81,74,76,251,B
781,53,37,85,56,231,C
782,47,39,67,57,210,C
783,26,72,79,44,221,C
784,58,80,83,87,308,B
785,33,82,84,40,239,C
786,61,57,50,73,241,B
787,46,53,47,52,198,C
788,57,88,38,42,225,C
789,72,59,75,27,233,C
790,36,78,85,90,289,B
791,41,57,30,60,188,C
792,72,70,69,76,287,B
793,53,27,64,83,227,C
794,81,75,82,81,319,B
795,48,62,39,57,206,C
796,46,60,50,71,227,C
797,45,62,42,60,209,C
798,44,84,49,63,240,B
799,67,79,74,89,309,B
800,46,88,40,31,205,C
801,32,48,34,59,173,C
802,29,31,82,65,207,C
803,80,22,90,34,226,C
804,90,39,82,86,297,B
805,25,63,21,60,169,C
806,62,45,24,57,188,C
807,75,89,70,81,315,B
808,43,30,37,48,158,D
809,48,86,68,54,256,B
810,20,65,61,73,219,C
811,40,50,51,35,176,C
812,85,25,36,68,214,C
813,28,87,51,37,203,C
814,87,33,74,25,219,C
815,64,66,67,53,250,B
816,59,59,66,88,272,B
817,68,62,73,81,284,B
818,56,31,48,31,166,C
819,34,24,38,20,116,D
820,81,21,69,62,233,C
821,82,79,72,38,271,B
822,74,38,26,76,214,C
823,47,38,80,76,241,B
824,54,40,67,71,232,C
825,90,61,51,72,274,B
826,29,57,85,86,257,B
827,49,24,28,69,170,C
828,58,53,32,72,215,C
829,67,32,75,32,206,C
830,81,40,62,69,252,B
831,52,42,28,22,144,D
832,26,25,33,57,141,D
833,28,77,31,29,165,C
834,77,31,21,30,159,D
835,64,37,24,87,212,C
836,32,89,71,88,280,B
837,42,42,78,43,205,C
838,72,82,21,53,228,C
839,79,29,66,47,221,C
840,21,86,81,83,271,B
841,24,53,27,28,132,D
842,68,86,23,60,237,C
843,25,75,42,86,228,C
844,43,22,82,68,215,C
845,60,83,34,54,231,C
846,47,33,55,70,205,C
847,44,73,83,44,244,B
848,57,70,56,47,230,C
849,89,71,75,89,324,A
850,85,48,85,20,238,C
851,34,87,24,21,166,C
852,55,63,49,62,229,C
853,52,58,50,47,207,C
854,21,29,43,46,139,D
855,37,47,79,63,226,C
856,40,83,27,87,237,C
857,74,69,60,63,266,B
858,41,51,76,21,189,C
859,68,57,87,59,271,B
860,83,31,49,82,245,B
861,83,71,27,26,207,C
862,47,59,32,61,199,C
863,45,87,83,74,289,B
864,68,50,62,21,201,C
865,85,45,77,81,288,B
866,51,78,48,28,205,C
867,37,20,20,37,114,D
868,67,73,78,64,282,B
869,56,80,39,59,234,C
870,81,49,45,55,230,C
871,25,24,27,27,103,D
872,74,44,57,70,245,B
873,65,21,77,90,253,B
874,76,51,76,32,235,C
875,87,44,53,65,249,B
876,29,59,42,61,191,C
877,30,74,64,29,197,C
878,46,51,54,60,211,C
879,57,86,75,61,279,B
880,54,74,63,55,246,B
881,51,20,83,27,181,C
882,47,32,66,67,212,C
883,51,61,52,36,200,C
884,72,90,48,29,239,C
885,83,20,37,54,194,C
886,49,87,78,78,292,B
887,48,50,20,51,169,C
888,84,59,69,57,269,B
889,49,62,54,55,220,C
890,22,27,83,30,162,C
891,79,90,53,84,306,B
892,83,74,38,43,238,C
893,23,90,40,72,225,C
894,60,54,37,24,175,C
895,77,24,76,74,251,B
896,73,66,80,24,243,B
897,50,29,54,51,184,C
898,73,40,86,36,235,C
899,29,30,54,49,162,C
900,77,49,65,61,252,B
901,80,48,27,53,208,C
902,76,28,85,46,235,C
903,56,46,37,75,214,C
904,80,52,85,59,276,B
905,28,89,48,36,201,C
906,74,78,67,54,273,B
907,59,58,50,55,222,C
908,28,62,62,66,218,C
909,62,89,39,56,246,B
910,21,86,75,28,210,C
911,57,24,26,36,143,D
912,76,33,69,34,212,C
913,58,58,51,80,247,B
914,62,81,68,49,260,B
915,82,63,50,78,273,B
916,30,43,43,68,184,C
917,42,57,46,31,176,C
918,69,59,75,29,232,C
919,21,53,70,36,180,C
920,76,33,67,30,206,C
921,25,81,35,59,200,C
922,38,34,45,23,140,D
923,29,32,90,75,226,C
924,23,32,71,79,205,C
925,42,86,80,53,261,B
926,74,44,41,61,220,C
927,41,49,80,28,198,C
928,24,89,57,83,253,B
929,23,63,71,42,199,C
930,82,53,31,63,229,C
931,66,40,45,39,190,C
932,54,82,29,49,214,C
933,33,66,51,86,236,C
934,79,74,36,59,248,B
935,22,83,22,56,183,C
936,42,65,29,50,186,C
937,88,48,50,34,220,C
938,83,86,67,84,320,A
939,58,36,25,26,145,D
940,80,42,25,34,181,C
941,44,80,24,47,195,C
942,23,33,71,82,209,C
943,56,26,71,88,241,B
944,67,84,64,63,278,B
945,67,41,45,56,209,C
946,81,67,26,57,231,C
947,27,90,34,80,231,C
948,25,20,87,83,215,C
949,40,45,22,21,128,D
950,77,87,90,40,294,B
951,31,41,33,65,170,C
952,89,22,47,51,209,C
953,31,24,50,22,127,D
954,86,67,51,60,264,B
955,49,36,65,87,237,C
956,34,74,73,34,215,C
957,60,21,31,24,136,D
958,70,84,50,83,287,B
959,41,62,59,24,186,C
960,55,57,61,84,257,B
961,32,61,88,50,231,C
962,69,56,81,49,255,B
963,70,64,68,30,232,C
964,74,29,27,49,179,C
965,75,68,83,79,305,B
966,88,62,31,28,209,C
967,73,78,59,39,249,B
968,52,66,42,42,202,C
969,34,89,66,67,256,B
970,28,45,33,74,180,C
971,29,49,71,48,197,C
972,63,32,51,82,228,C
973,38,75,47,28,188,C
974,67,79,72,85,303,B
975,29,52,40,50,171,C
976,89,50,59,75,273,B
977,26,25,49,89,189,C
978,54,52,62,78,246,B
979,22,76,68,39,205,C
980,89,31,20,65,205,C
981,42,42,49,90,223,C
982,38,72,56,83,249,B
983,32,75,60,49,216,C
984,36,57,52,67,212,C
985,57,65,33,30,185,C
986,50,49,82,48,229,C
987,62,77,26,90,255,B
988,85,63,52,32,232,C
989,21,89,34,33,177,C
990,74,41,38,37,190,C
991,39,52,34,70,195,C
992,51,56,66,60,233,C
993,68,85,41,58,252,B
994,59,56,48,55,218,C
995,53,64,31,48,196,C
996,78,22,35,90,225,C
997,32,56,53,36,177,C
998,44,41,21,45,151,D
999,44,40,69,32,185,C
1000,72,22,45,66,205,C
1001,82,63,45,72,262,B
1002,66,82,64,77,289,B
1003,43,33,44,37,157,D
1004,87,54,44,33,218,C
1005,62,69,72,28,231,C
1006,32,56,41,31,160,C
1007,65,37,72,69,243,B
1008,39,24,27,28,118,D
1009,68,84,61,25,238,C
1010,64,60,21,56,201,C
1011,50,61,29,26,166,C
1012,42,74,40,86,242,B
1013,71,46,71,29,217,C
1014,82,45,35,90,252,B
1015,32,44,68,56,200,C
1016,75,39,79,52,245,B
1017,76,51,51,79,257,B
1018,63,80,46,65,254,B
1019,20,86,90,75,271,B
1020,61,61,39,38,199,C
1021,83,32,55,55,225,C
1022,34,32,47,30,143,D
1023,84,52,73,54,263,B
1024,28,35,36,22,121,D
1025,47,90,46,74,257,B
1026,42,76,47,41,206,C
1027,45,24,56,66,191,C
1028,70,53,38,52,213,C
1029,21,60,33,61,175,C
1030,35,23,62,37,157,D
1031,89,54,53,85,281,B
1032,42,79,87,73,281,B
1033,67,55,23,64,209,C
1034,51,44,49,64,208,C
1035,82,27,62,48,219,C
1036,43,57,82,74,256,B
1037,79,52,45,66,242,B
1038,42,34,55,52,183,C
1039,59,24,61,49,193,C
1040,33,35,52,57,177,C
1041,32,41,40,48,161,C
1042,58,71,40,58,227,C
1043,38,21,47,74,180,C
1044,44,24,62,29,159,D
1045,21,89,79,37,226,C
1046,21,84,54,35,194,C
1047,69,90,66,41,266,B
1048,45,23,46,41,155,D
1049,65,56,78,50,249,B
1050,51,22,40,74,187,C
1051,29,85,63,49,226,C
1052,69,73,45,87,274,B
1053,58,65,66,55,244,B
1054,61,50,65,31,207,C
1055,43,40,61,32,176,C
1056,77,50,70,57,254,B
1057,71,34,34,68,207,C
1058,22,66,22,20,130,D
1059,74,37,25,71,207,C
1060,24,56,90,74,244,B
1061,57,50,45,54,206,C
1062,56,26,71,21,174,C
1063,77,79,44,89,289,B
1064,31,44,66,61,202,C
1065,40,76,44,45,205,C
1066,56,41,54,72,223,C
1067,80,71,87,33,271,B
1068,47,43,27,48,165,C
1069,80,85,65,53,283,B
1070,88,25,73,34,220,C
1071,62,54,31,21,168,C
1072,56,54,83,36,229,C
1073,52,44,77,25,198,C
1074,47,60,89,46,242,B
1075,65,63,41,88,257,B
1076,45,55,53,65,218,C
1077,72,82,46,21,221,C
1078,23,49,88,76,236,C
1079,39,47,78,33,197,C
1080,65,28,38,65,196,C
1081,80,67,26,90,263,B
1082,72,85,71,90,318,B
1083,65,77,42,24,208,C
1084,72,76,46,48,242,B
1085,89,80,69,22,260,B
1086,53,72,24,66,215,C
1087,41,34,62,81,218,C
1088,45,40,77,42,204,C
1089,47,90,60,50,247,B
1090,26,33,41,89,189,C
1091,34,65,81,41,221,C
1092,69,56,44,84,253,B
1093,78,24,48,49,199,C
1094,29,63,64,71,227,C
1095,26,50,72,34,182,C
1096,44,66,37,39,186,C
1097,77,70,20,81,248,B
1098,63,45,77,32,217,C
1099,74,68,40,52,234,C
